1111111111
1010000001
10P1110C01
1000C00001
1000C0E001
1000C00001
1111111111