111111111111111111111
100000000000000000011
1000000P0000000000001
1E0000000000000000001
100000000C000000000001
100000000000000000001
100000000C00000000001
111111111111111111111