111111
1P00C1
100001
100001
1000E1
100001
111111